...#.#.##..
.#...#...#.
.....#.#.#.
.....#.#.#.
.....#.#.#.
...........
